#########################################
 ########################################
######         ###   ###   ###     ######
######## ### ####### ### ####### ########
#### ### ### ### ### ### ### ### ### ####
#### ### ####### ### ### ### ### ### ####
##         ###                         ##
#### ### ########### ########### ### ####
#### ### ### ####### ########### ### ####
######## ### ####### ############### ####
######                         ###     ##
######## ### ### ### ### ### ####### ####
#### ### ### ### ### ### ### ####### ####
#### ### ####### ### ### ### ####### ####
##         ###   ### ### ###   ###   ####
######## ####### ### ####### ############
######## ### ### ###   ###   ### ##### ##
######## ### ### ### ####### ### ##### ##
##       ###     ### #######           ##
######################################## 
#########################################
