#########################################
    #   #       #   #     # #         # #
### # # ##### # # # ### # # # ### ### # #
# # # #       #   #   # # # # # # #   # #
# # # ############### # # # # # # ### # #
# # #   #         #   # # #     #   #   #
# # # # ##### ### # ### # ##### ### #####
# # # #     #   # #     #   #     #     #
# # # ##### ### # ######### ######### # #
# # #     #   # #     #     #   #   # # #
# # ######### # # # ### ##### # # # ### #
# #       #   # # # #   # #   #   #     #
# ####### # ### # ### ### # # ######### #
#   # #   #   # #     # #   #     #   # #
# # # # ##### ### ##### # ####### # ### #
# # # #     #   # #     #       # #     #
# # # ##### # # # ##### ### ##### ### ###
# #     #   # # # #   #     #   #   #   #
# ####### ##### # # # ####### # ### ### #
#               #   #         #     #    
#########################################
